,date,rank,country,ct,points,previousPoints,flag,delta
0,2000-09-06T00:00:00,1,Brazil,BRA,818,819,https://api.fifa.com/api/v1/picture/flags-sq-4/bra,-1
1,2000-09-06T00:00:00,2,France,FRA,807,808,https://api.fifa.com/api/v1/picture/flags-sq-4/fra,-1
2,2000-09-06T00:00:00,3,Argentina,ARG,752,749,https://api.fifa.com/api/v1/picture/flags-sq-4/arg,3
3,2000-09-06T00:00:00,4,Czech Republic,CZE,746,745,https://api.fifa.com/api/v1/picture/flags-sq-4/cze,1
4,2000-09-06T00:00:00,5,Spain,ESP,740,743,https://api.fifa.com/api/v1/picture/flags-sq-4/esp,-3
5,2000-09-06T00:00:00,6,Italy,ITA,725,729,https://api.fifa.com/api/v1/picture/flags-sq-4/ita,-4
6,2000-09-06T00:00:00,7,Portugal,POR,724,716,https://api.fifa.com/api/v1/picture/flags-sq-4/por,8
7,2000-09-06T00:00:00,8,Yugoslavia,YUG,714,704,https://api.fifa.com/api/v1/picture/flags-sq-4/yug,10
8,2000-09-06T00:00:00,9,Germany,GER,712,700,https://api.fifa.com/api/v1/picture/flags-sq-4/ger,12
9,2000-09-06T00:00:00,10,Netherlands,NED,710,710,https://api.fifa.com/api/v1/picture/flags-sq-4/ned,0
10,2000-09-06T00:00:00,11,Norway,NOR,698,705,https://api.fifa.com/api/v1/picture/flags-sq-4/nor,-7
11,2000-09-06T00:00:00,12,Romania,ROU,698,695,https://api.fifa.com/api/v1/picture/flags-sq-4/rou,3
12,2000-09-06T00:00:00,13,Mexico,MEX,693,688,https://api.fifa.com/api/v1/picture/flags-sq-4/mex,5
13,2000-09-06T00:00:00,14,England,ENG,682,689,https://api.fifa.com/api/v1/picture/flags-sq-4/eng,-7
14,2000-09-06T00:00:00,15,Croatia,CRO,675,687,https://api.fifa.com/api/v1/picture/flags-sq-4/cro,-12
15,2000-09-06T00:00:00,16,Paraguay,PAR,672,655,https://api.fifa.com/api/v1/picture/flags-sq-4/par,17
16,2000-09-06T00:00:00,17,Colombia,COL,668,648,https://api.fifa.com/api/v1/picture/flags-sq-4/col,20
17,2000-09-06T00:00:00,18,Denmark,DEN,652,639,https://api.fifa.com/api/v1/picture/flags-sq-4/den,13
18,2000-09-06T00:00:00,19,USA,USA,646,627,https://api.fifa.com/api/v1/picture/flags-sq-4/usa,19
19,2000-09-06T00:00:00,20,Chile,CHI,645,625,https://api.fifa.com/api/v1/picture/flags-sq-4/chi,20
20,2000-09-06T00:00:00,21,Sweden,SWE,639,638,https://api.fifa.com/api/v1/picture/flags-sq-4/swe,1
21,2000-09-06T00:00:00,22,Scotland,SCO,631,625,https://api.fifa.com/api/v1/picture/flags-sq-4/sco,6
22,2000-09-06T00:00:00,23,South Africa,RSA,631,629,https://api.fifa.com/api/v1/picture/flags-sq-4/rsa,2
23,2000-09-06T00:00:00,24,Russia,RUS,625,606,https://api.fifa.com/api/v1/picture/flags-sq-4/rus,19
24,2000-09-06T00:00:00,25,Belgium,BEL,607,596,https://api.fifa.com/api/v1/picture/flags-sq-4/bel,11
25,2000-09-06T00:00:00,26,Morocco,MAR,605,609,https://api.fifa.com/api/v1/picture/flags-sq-4/mar,-4
26,2000-09-06T00:00:00,27,Tunisia,TUN,605,606,https://api.fifa.com/api/v1/picture/flags-sq-4/tun,-1
27,2000-09-06T00:00:00,28,Slovakia,SVK,604,598,https://api.fifa.com/api/v1/picture/flags-sq-4/svk,6
28,2000-09-06T00:00:00,29,Trinidad and Tobago,TRI,597,586,https://api.fifa.com/api/v1/picture/flags-sq-4/tri,11
29,2000-09-06T00:00:00,30,Turkey,TUR,588,586,https://api.fifa.com/api/v1/picture/flags-sq-4/tur,2
30,2000-09-06T00:00:00,31,Egypt,EGY,586,581,https://api.fifa.com/api/v1/picture/flags-sq-4/egy,5
31,2000-09-06T00:00:00,32,Uruguay,URU,583,572,https://api.fifa.com/api/v1/picture/flags-sq-4/uru,11
32,2000-09-06T00:00:00,33,Greece,GRE,581,581,https://api.fifa.com/api/v1/picture/flags-sq-4/gre,0
33,2000-09-06T00:00:00,34,Cameroon,CMR,580,580,https://api.fifa.com/api/v1/picture/flags-sq-4/cmr,0
34,2000-09-06T00:00:00,35,Israel,ISR,577,572,https://api.fifa.com/api/v1/picture/flags-sq-4/isr,5
35,2000-09-06T00:00:00,36,Poland,POL,568,548,https://api.fifa.com/api/v1/picture/flags-sq-4/pol,20
36,2000-09-06T00:00:00,37,Slovenia,SVN,568,559,https://api.fifa.com/api/v1/picture/flags-sq-4/svn,9
37,2000-09-06T00:00:00,38,Republic of Ireland,IRL,565,561,https://api.fifa.com/api/v1/picture/flags-sq-4/irl,4
38,2000-09-06T00:00:00,39,Jamaica,JAM,565,543,https://api.fifa.com/api/v1/picture/flags-sq-4/jam,22
39,2000-09-06T00:00:00,40,Peru,PER,565,554,https://api.fifa.com/api/v1/picture/flags-sq-4/per,11
40,2000-09-06T00:00:00,41,Ukraine,UKR,565,580,https://api.fifa.com/api/v1/picture/flags-sq-4/ukr,-15
41,2000-09-06T00:00:00,42,Austria,AUT,563,554,https://api.fifa.com/api/v1/picture/flags-sq-4/aut,9
42,2000-09-06T00:00:00,43,Korea Republic,KOR,563,565,https://api.fifa.com/api/v1/picture/flags-sq-4/kor,-2
43,2000-09-06T00:00:00,44,IR Iran,IRN,559,561,https://api.fifa.com/api/v1/picture/flags-sq-4/irn,-2
44,2000-09-06T00:00:00,45,Zambia,ZAM,557,561,https://api.fifa.com/api/v1/picture/flags-sq-4/zam,-4
45,2000-09-06T00:00:00,46,Honduras,HON,545,534,https://api.fifa.com/api/v1/picture/flags-sq-4/hon,11
46,2000-09-06T00:00:00,47,Finland,FIN,543,526,https://api.fifa.com/api/v1/picture/flags-sq-4/fin,17
47,2000-09-06T00:00:00,48,CÃ´te d'Ivoire,CIV,542,547,https://api.fifa.com/api/v1/picture/flags-sq-4/civ,-5
48,2000-09-06T00:00:00,49,Hungary,HUN,540,528,https://api.fifa.com/api/v1/picture/flags-sq-4/hun,12
49,2000-09-06T00:00:00,50,Japan,JPN,537,535,https://api.fifa.com/api/v1/picture/flags-sq-4/jpn,2
50,2000-09-06T00:00:00,51,Angola,ANG,536,539,https://api.fifa.com/api/v1/picture/flags-sq-4/ang,-3
51,2000-09-06T00:00:00,52,Iceland,ISL,531,530,https://api.fifa.com/api/v1/picture/flags-sq-4/isl,1
52,2000-09-06T00:00:00,53,Ghana,GHA,530,531,https://api.fifa.com/api/v1/picture/flags-sq-4/gha,-1
53,2000-09-06T00:00:00,54,Nigeria,NGA,530,521,https://api.fifa.com/api/v1/picture/flags-sq-4/nga,9
54,2000-09-06T00:00:00,55,Costa Rica,CRC,524,512,https://api.fifa.com/api/v1/picture/flags-sq-4/crc,12
55,2000-09-06T00:00:00,56,Bulgaria,BUL,522,529,https://api.fifa.com/api/v1/picture/flags-sq-4/bul,-7
56,2000-09-06T00:00:00,57,Thailand,THA,515,514,https://api.fifa.com/api/v1/picture/flags-sq-4/tha,1
57,2000-09-06T00:00:00,58,Canada,CAN,512,518,https://api.fifa.com/api/v1/picture/flags-sq-4/can,-6
58,2000-09-06T00:00:00,59,United Arab Emirates,UAE,512,514,https://api.fifa.com/api/v1/picture/flags-sq-4/uae,-2
59,2000-09-06T00:00:00,60,Ecuador,ECU,511,500,https://api.fifa.com/api/v1/picture/flags-sq-4/ecu,11
60,2000-09-06T00:00:00,61,Switzerland,SUI,511,507,https://api.fifa.com/api/v1/picture/flags-sq-4/sui,4
61,2000-09-06T00:00:00,62,Guatemala,GUA,510,513,https://api.fifa.com/api/v1/picture/flags-sq-4/gua,-3
62,2000-09-06T00:00:00,63,Saudi Arabia,KSA,507,517,https://api.fifa.com/api/v1/picture/flags-sq-4/ksa,-10
63,2000-09-06T00:00:00,64,Zimbabwe,ZIM,500,483,https://api.fifa.com/api/v1/picture/flags-sq-4/zim,17
64,2000-09-06T00:00:00,65,Cyprus,CYP,499,502,https://api.fifa.com/api/v1/picture/flags-sq-4/cyp,-3
65,2000-09-06T00:00:00,66,Congo DR,COD,493,496,https://api.fifa.com/api/v1/picture/flags-sq-4/cod,-3
66,2000-09-06T00:00:00,67,Australia,AUS,492,497,https://api.fifa.com/api/v1/picture/flags-sq-4/aus,-5
67,2000-09-06T00:00:00,68,Georgia,GEO,492,495,https://api.fifa.com/api/v1/picture/flags-sq-4/geo,-3
68,2000-09-06T00:00:00,69,Lithuania,LTU,492,494,https://api.fifa.com/api/v1/picture/flags-sq-4/ltu,-2
69,2000-09-06T00:00:00,70,Bolivia,BOL,491,494,https://api.fifa.com/api/v1/picture/flags-sq-4/bol,-3
70,2000-09-06T00:00:00,71,Kuwait,KUW,490,495,https://api.fifa.com/api/v1/picture/flags-sq-4/kuw,-5
71,2000-09-06T00:00:00,72,Uzbekistan,UZB,485,501,https://api.fifa.com/api/v1/picture/flags-sq-4/uzb,-16
72,2000-09-06T00:00:00,73,China PR,CHN,481,476,https://api.fifa.com/api/v1/picture/flags-sq-4/chn,5
73,2000-09-06T00:00:00,74,Bosnia and Herzegovina,BIH,475,452,https://api.fifa.com/api/v1/picture/flags-sq-4/bih,23
74,2000-09-06T00:00:00,75,Burkina Faso,BFA,471,467,https://api.fifa.com/api/v1/picture/flags-sq-4/bfa,4
75,2000-09-06T00:00:00,76,Cuba,CUB,467,467,https://api.fifa.com/api/v1/picture/flags-sq-4/cub,0
76,2000-09-06T00:00:00,77,Estonia,EST,465,461,https://api.fifa.com/api/v1/picture/flags-sq-4/est,4
77,2000-09-06T00:00:00,78,Guinea,GUI,464,469,https://api.fifa.com/api/v1/picture/flags-sq-4/gui,-5
78,2000-09-06T00:00:00,79,Armenia,ARM,462,441,https://api.fifa.com/api/v1/picture/flags-sq-4/arm,21
79,2000-09-06T00:00:00,80,Algeria,ALG,461,462,https://api.fifa.com/api/v1/picture/flags-sq-4/alg,-1
80,2000-09-06T00:00:00,81,Iraq,IRQ,456,442,https://api.fifa.com/api/v1/picture/flags-sq-4/irq,14
81,2000-09-06T00:00:00,82,Namibia,NAM,455,462,https://api.fifa.com/api/v1/picture/flags-sq-4/nam,-7
82,2000-09-06T00:00:00,83,Gabon,GAB,453,439,https://api.fifa.com/api/v1/picture/flags-sq-4/gab,14
83,2000-09-06T00:00:00,84,Haiti,HAI,452,449,https://api.fifa.com/api/v1/picture/flags-sq-4/hai,3
84,2000-09-06T00:00:00,85,Senegal,SEN,452,456,https://api.fifa.com/api/v1/picture/flags-sq-4/sen,-4
85,2000-09-06T00:00:00,86,Latvia,LVA,450,457,https://api.fifa.com/api/v1/picture/flags-sq-4/lva,-7
86,2000-09-06T00:00:00,87,FYR Macedonia,MKD,442,447,https://api.fifa.com/api/v1/picture/flags-sq-4/mkd,-5
87,2000-09-06T00:00:00,88,Albania,ALB,441,439,https://api.fifa.com/api/v1/picture/flags-sq-4/alb,2
88,2000-09-06T00:00:00,89,Mali,MLI,440,443,https://api.fifa.com/api/v1/picture/flags-sq-4/mli,-3
89,2000-09-06T00:00:00,90,Togo,TOG,437,441,https://api.fifa.com/api/v1/picture/flags-sq-4/tog,-4
90,2000-09-06T00:00:00,91,New Zealand,NZL,434,414,https://api.fifa.com/api/v1/picture/flags-sq-4/nzl,20
91,2000-09-06T00:00:00,92,Qatar,QAT,434,438,https://api.fifa.com/api/v1/picture/flags-sq-4/qat,-4
92,2000-09-06T00:00:00,93,Congo,CGO,433,434,https://api.fifa.com/api/v1/picture/flags-sq-4/cgo,-1
93,2000-09-06T00:00:00,94,El Salvador,SLV,432,443,https://api.fifa.com/api/v1/picture/flags-sq-4/slv,-11
94,2000-09-06T00:00:00,95,Liberia,LBR,427,394,https://api.fifa.com/api/v1/picture/flags-sq-4/lbr,33
95,2000-09-06T00:00:00,96,Northern Ireland,NIR,425,404,https://api.fifa.com/api/v1/picture/flags-sq-4/nir,21
96,2000-09-06T00:00:00,97,Moldova,MDA,423,415,https://api.fifa.com/api/v1/picture/flags-sq-4/mda,8
97,2000-09-06T00:00:00,98,Syria,SYR,417,410,https://api.fifa.com/api/v1/picture/flags-sq-4/syr,7
98,2000-09-06T00:00:00,99,Barbados,BRB,414,422,https://api.fifa.com/api/v1/picture/flags-sq-4/brb,-8
99,2000-09-06T00:00:00,100,Belarus,BLR,403,365,https://api.fifa.com/api/v1/picture/flags-sq-4/blr,38
100,2000-09-06T00:00:00,101,Uganda,UGA,399,377,https://api.fifa.com/api/v1/picture/flags-sq-4/uga,22
101,2000-09-06T00:00:00,102,Indonesia,IDN,394,395,https://api.fifa.com/api/v1/picture/flags-sq-4/idn,-1
102,2000-09-06T00:00:00,103,Jordan,JOR,386,385,https://api.fifa.com/api/v1/picture/flags-sq-4/jor,1
103,2000-09-06T00:00:00,104,Malaysia,MAS,376,364,https://api.fifa.com/api/v1/picture/flags-sq-4/mas,12
104,2000-09-06T00:00:00,105,Mozambique,MOZ,375,377,https://api.fifa.com/api/v1/picture/flags-sq-4/moz,-2
105,2000-09-06T00:00:00,106,Singapore,SIN,375,382,https://api.fifa.com/api/v1/picture/flags-sq-4/sin,-7
106,2000-09-06T00:00:00,107,Venezuela,VEN,375,361,https://api.fifa.com/api/v1/picture/flags-sq-4/ven,14
107,2000-09-06T00:00:00,108,Kenya,KEN,374,367,https://api.fifa.com/api/v1/picture/flags-sq-4/ken,7
108,2000-09-06T00:00:00,109,Oman,OMA,374,372,https://api.fifa.com/api/v1/picture/flags-sq-4/oma,2
109,2000-09-06T00:00:00,110,Lebanon,LBN,368,365,https://api.fifa.com/api/v1/picture/flags-sq-4/lbn,3
110,2000-09-06T00:00:00,111,Vietnam,VIE,367,378,https://api.fifa.com/api/v1/picture/flags-sq-4/vie,-11
111,2000-09-06T00:00:00,112,Azerbaijan,AZE,366,369,https://api.fifa.com/api/v1/picture/flags-sq-4/aze,-3
112,2000-09-06T00:00:00,113,Wales,WAL,361,379,https://api.fifa.com/api/v1/picture/flags-sq-4/wal,-18
113,2000-09-06T00:00:00,114,Malawi,MWI,359,360,https://api.fifa.com/api/v1/picture/flags-sq-4/mwi,-1
114,2000-09-06T00:00:00,115,Madagascar,MAD,351,313,https://api.fifa.com/api/v1/picture/flags-sq-4/mad,38
115,2000-09-06T00:00:00,116,India,IND,349,350,https://api.fifa.com/api/v1/picture/flags-sq-4/ind,-1
116,2000-09-06T00:00:00,117,Faroe Islands,FRO,340,318,https://api.fifa.com/api/v1/picture/flags-sq-4/fro,22
117,2000-09-06T00:00:00,118,Kazakhstan,KAZ,330,331,https://api.fifa.com/api/v1/picture/flags-sq-4/kaz,-1
118,2000-09-06T00:00:00,119,Mauritius,MRI,330,335,https://api.fifa.com/api/v1/picture/flags-sq-4/mri,-5
119,2000-09-06T00:00:00,120,Malta,MLT,318,323,https://api.fifa.com/api/v1/picture/flags-sq-4/mlt,-5
120,2000-09-06T00:00:00,121,Turkmenistan,TKM,317,317,https://api.fifa.com/api/v1/picture/flags-sq-4/tkm,0
121,2000-09-06T00:00:00,122,Panama,PAN,311,312,https://api.fifa.com/api/v1/picture/flags-sq-4/pan,-1
122,2000-09-06T00:00:00,123,Libya,LBY,309,303,https://api.fifa.com/api/v1/picture/flags-sq-4/lby,6
123,2000-09-06T00:00:00,124,St. Vincent and the Grenadines,VIN,303,307,https://api.fifa.com/api/v1/picture/flags-sq-4/vin,-4
124,2000-09-06T00:00:00,125,Hong Kong,HKG,300,301,https://api.fifa.com/api/v1/picture/flags-sq-4/hkg,-1
125,2000-09-06T00:00:00,126,Sierra Leone,SLE,298,275,https://api.fifa.com/api/v1/picture/flags-sq-4/sle,23
126,2000-09-06T00:00:00,127,Sudan,SDN,297,299,https://api.fifa.com/api/v1/picture/flags-sq-4/sdn,-2
127,2000-09-06T00:00:00,128,Myanmar,MYA,292,271,https://api.fifa.com/api/v1/picture/flags-sq-4/mya,21
128,2000-09-06T00:00:00,129,St. Lucia,LCA,288,286,https://api.fifa.com/api/v1/picture/flags-sq-4/lca,2
129,2000-09-06T00:00:00,130,Tahiti,TAH,287,287,https://api.fifa.com/api/v1/picture/flags-sq-4/tah,0
130,2000-09-06T00:00:00,131,Solomon Islands,SOL,284,283,https://api.fifa.com/api/v1/picture/flags-sq-4/sol,1
131,2000-09-06T00:00:00,132,Bahrain,BHR,277,285,https://api.fifa.com/api/v1/picture/flags-sq-4/bhr,-8
132,2000-09-06T00:00:00,133,Eswatini,SWZ,267,269,https://api.fifa.com/api/v1/picture/flags-sq-4/swz,-2
133,2000-09-06T00:00:00,134,Burundi,BDI,262,242,https://api.fifa.com/api/v1/picture/flags-sq-4/bdi,20
134,2000-09-06T00:00:00,135,Tajikistan,TJK,261,266,https://api.fifa.com/api/v1/picture/flags-sq-4/tjk,-5
135,2000-09-06T00:00:00,136,Fiji,FIJ,260,262,https://api.fifa.com/api/v1/picture/flags-sq-4/fij,-2
136,2000-09-06T00:00:00,137,Luxembourg,LUX,258,256,https://api.fifa.com/api/v1/picture/flags-sq-4/lux,2
137,2000-09-06T00:00:00,138,Grenada,GRN,257,260,https://api.fifa.com/api/v1/picture/flags-sq-4/grn,-3
138,2000-09-06T00:00:00,139,Lesotho,LES,255,260,https://api.fifa.com/api/v1/picture/flags-sq-4/les,-5
139,2000-09-06T00:00:00,140,Rwanda,RWA,252,252,https://api.fifa.com/api/v1/picture/flags-sq-4/rwa,0
140,2000-09-06T00:00:00,141,Tanzania,TAN,251,255,https://api.fifa.com/api/v1/picture/flags-sq-4/tan,-4
141,2000-09-06T00:00:00,142,Ethiopia,ETH,246,247,https://api.fifa.com/api/v1/picture/flags-sq-4/eth,-1
142,2000-09-06T00:00:00,143,Bangladesh,BAN,245,246,https://api.fifa.com/api/v1/picture/flags-sq-4/ban,-1
143,2000-09-06T00:00:00,144,Benin,BEN,245,246,https://api.fifa.com/api/v1/picture/flags-sq-4/ben,-1
144,2000-09-06T00:00:00,145,Liechtenstein,LIE,245,252,https://api.fifa.com/api/v1/picture/flags-sq-4/lie,-7
145,2000-09-06T00:00:00,146,St. Kitts and Nevis,SKN,243,243,https://api.fifa.com/api/v1/picture/flags-sq-4/skn,0
146,2000-09-06T00:00:00,147,Korea DPR,PRK,240,239,https://api.fifa.com/api/v1/picture/flags-sq-4/prk,1
147,2000-09-06T00:00:00,148,Antigua and Barbuda,ATG,236,234,https://api.fifa.com/api/v1/picture/flags-sq-4/atg,2
148,2000-09-06T00:00:00,149,Andorra,AND,235,214,https://api.fifa.com/api/v1/picture/flags-sq-4/and,21
149,2000-09-06T00:00:00,150,Bermuda,BER,218,218,https://api.fifa.com/api/v1/picture/flags-sq-4/ber,0
150,2000-09-06T00:00:00,151,Botswana,BOT,217,215,https://api.fifa.com/api/v1/picture/flags-sq-4/bot,2
151,2000-09-06T00:00:00,152,Gambia,GAM,216,217,https://api.fifa.com/api/v1/picture/flags-sq-4/gam,-1
152,2000-09-06T00:00:00,153,Maldives,MDV,215,215,https://api.fifa.com/api/v1/picture/flags-sq-4/mdv,0
153,2000-09-06T00:00:00,154,Sri Lanka,SRI,214,215,https://api.fifa.com/api/v1/picture/flags-sq-4/sri,-1
154,2000-09-06T00:00:00,155,Dominican Republic,DOM,206,206,https://api.fifa.com/api/v1/picture/flags-sq-4/dom,0
155,2000-09-06T00:00:00,156,Cape Verde Islands,CPV,198,196,https://api.fifa.com/api/v1/picture/flags-sq-4/cpv,2
156,2000-09-06T00:00:00,157,Mauritania,MTN,193,194,https://api.fifa.com/api/v1/picture/flags-sq-4/mtn,-1
157,2000-09-06T00:00:00,158,Yemen,YEM,191,192,https://api.fifa.com/api/v1/picture/flags-sq-4/yem,-1
158,2000-09-06T00:00:00,159,Cayman Islands,CAY,184,181,https://api.fifa.com/api/v1/picture/flags-sq-4/cay,3
159,2000-09-06T00:00:00,160,Dominica,DMA,183,183,https://api.fifa.com/api/v1/picture/flags-sq-4/dma,0
160,2000-09-06T00:00:00,161,Chinese Taipei,TPE,178,173,https://api.fifa.com/api/v1/picture/flags-sq-4/tpe,5
161,2000-09-06T00:00:00,162,Nepal,NEP,174,174,https://api.fifa.com/api/v1/picture/flags-sq-4/nep,0
162,2000-09-06T00:00:00,163,Chad,CHA,173,171,https://api.fifa.com/api/v1/picture/flags-sq-4/cha,2
163,2000-09-06T00:00:00,164,Eritrea,ERI,172,165,https://api.fifa.com/api/v1/picture/flags-sq-4/eri,7
164,2000-09-06T00:00:00,165,Suriname,SUR,170,169,https://api.fifa.com/api/v1/picture/flags-sq-4/sur,1
165,2000-09-06T00:00:00,166,Laos,LAO,169,169,https://api.fifa.com/api/v1/picture/flags-sq-4/lao,0
166,2000-09-06T00:00:00,167,San Marino,SMR,158,161,https://api.fifa.com/api/v1/picture/flags-sq-4/smr,-3
167,2000-09-06T00:00:00,168,Vanuatu,VAN,153,151,https://api.fifa.com/api/v1/picture/flags-sq-4/van,2
168,2000-09-06T00:00:00,169,Palestine,PLE,152,141,https://api.fifa.com/api/v1/picture/flags-sq-4/ple,11
169,2000-09-06T00:00:00,170,Cook Islands,COK,149,147,https://api.fifa.com/api/v1/picture/flags-sq-4/cok,2
170,2000-09-06T00:00:00,171,British Virgin Islands,VGB,144,144,https://api.fifa.com/api/v1/picture/flags-sq-4/vgb,0
171,2000-09-06T00:00:00,172,Kyrgyz Republic,KGZ,138,140,https://api.fifa.com/api/v1/picture/flags-sq-4/kgz,-2
172,2000-09-06T00:00:00,174,Samoa,SAM,135,134,https://api.fifa.com/api/v1/picture/flags-sq-4/sam,1
173,2000-09-06T00:00:00,175,Guinea-Bissau,GNB,129,130,https://api.fifa.com/api/v1/picture/flags-sq-4/gnb,-1
174,2000-09-06T00:00:00,176,Central African Republic,CTA,125,124,https://api.fifa.com/api/v1/picture/flags-sq-4/cta,1
175,2000-09-06T00:00:00,177,Niger,NIG,121,125,https://api.fifa.com/api/v1/picture/flags-sq-4/nig,-4
176,2000-09-06T00:00:00,178,Macau,MAC,116,116,https://api.fifa.com/api/v1/picture/flags-sq-4/mac,0
177,2000-09-06T00:00:00,179,Sao Tome e Principe,STP,112,112,https://api.fifa.com/api/v1/picture/flags-sq-4/stp,0
178,2000-09-06T00:00:00,180,Bahamas,BAH,108,106,https://api.fifa.com/api/v1/picture/flags-sq-4/bah,2
179,2000-09-06T00:00:00,181,Cambodia,CAM,108,110,https://api.fifa.com/api/v1/picture/flags-sq-4/cam,-2
180,2000-09-06T00:00:00,182,Guyana,GUY,105,98,https://api.fifa.com/api/v1/picture/flags-sq-4/guy,7
181,2000-09-06T00:00:00,183,Philippines,PHI,103,104,https://api.fifa.com/api/v1/picture/flags-sq-4/phi,-1
182,2000-09-06T00:00:00,184,Tonga,TGA,99,100,https://api.fifa.com/api/v1/picture/flags-sq-4/tga,-1
183,2000-09-06T00:00:00,185,Aruba,ARU,95,94,https://api.fifa.com/api/v1/picture/flags-sq-4/aru,1
184,2000-09-06T00:00:00,186,Belize,BLZ,93,93,https://api.fifa.com/api/v1/picture/flags-sq-4/blz,0
185,2000-09-06T00:00:00,187,Equatorial Guinea,EQG,90,90,https://api.fifa.com/api/v1/picture/flags-sq-4/eqg,0
186,2000-09-06T00:00:00,188,Seychelles,SEY,80,80,https://api.fifa.com/api/v1/picture/flags-sq-4/sey,0
187,2000-09-06T00:00:00,189,Pakistan,PAK,79,80,https://api.fifa.com/api/v1/picture/flags-sq-4/pak,-1
188,2000-09-06T00:00:00,190,Nicaragua,NCA,71,71,https://api.fifa.com/api/v1/picture/flags-sq-4/nca,0
189,2000-09-06T00:00:00,191,Papua New Guinea,PNG,69,70,https://api.fifa.com/api/v1/picture/flags-sq-4/png,-1
190,2000-09-06T00:00:00,192,Djibouti,DJI,65,65,https://api.fifa.com/api/v1/picture/flags-sq-4/dji,0
191,2000-09-06T00:00:00,193,Brunei Darussalam,BRU,64,64,https://api.fifa.com/api/v1/picture/flags-sq-4/bru,0
192,2000-09-06T00:00:00,194,Puerto Rico,PUR,57,58,https://api.fifa.com/api/v1/picture/flags-sq-4/pur,-1
193,2000-09-06T00:00:00,195,Somalia,SOM,40,40,https://api.fifa.com/api/v1/picture/flags-sq-4/som,0
194,2000-09-06T00:00:00,196,US Virgin Islands,VIR,33,33,https://api.fifa.com/api/v1/picture/flags-sq-4/vir,0
195,2000-09-06T00:00:00,197,Mongolia,MNG,32,31,https://api.fifa.com/api/v1/picture/flags-sq-4/mng,1
196,2000-09-06T00:00:00,198,Anguilla,AIA,31,30,https://api.fifa.com/api/v1/picture/flags-sq-4/aia,1
197,2000-09-06T00:00:00,199,Turks and Caicos Islands,TCA,22,22,https://api.fifa.com/api/v1/picture/flags-sq-4/tca,0
198,2000-09-06T00:00:00,200,Bhutan,BHU,15,15,https://api.fifa.com/api/v1/picture/flags-sq-4/bhu,0
199,2000-09-06T00:00:00,201,Guam,GUM,14,14,https://api.fifa.com/api/v1/picture/flags-sq-4/gum,0
200,2000-09-06T00:00:00,202,Montserrat,MSR,11,11,https://api.fifa.com/api/v1/picture/flags-sq-4/msr,0
201,2000-09-06T00:00:00,203,American Samoa,ASA,8,8,https://api.fifa.com/api/v1/picture/flags-sq-4/asa,0
