,date,rank,country,ct,points,previousPoints,flag,delta
0,2006-03-15T00:00:00,1,Brazil,BRA,835,837,https://api.fifa.com/api/v1/picture/flags-sq-4/bra,-2
1,2006-03-15T00:00:00,2,Czech Republic,CZE,789,793,https://api.fifa.com/api/v1/picture/flags-sq-4/cze,-4
2,2006-03-15T00:00:00,3,Netherlands,NED,788,791,https://api.fifa.com/api/v1/picture/flags-sq-4/ned,-3
3,2006-03-15T00:00:00,4,Argentina,ARG,765,769,https://api.fifa.com/api/v1/picture/flags-sq-4/arg,-4
4,2006-03-15T00:00:00,5,USA,USA,764,765,https://api.fifa.com/api/v1/picture/flags-sq-4/usa,-1
5,2006-03-15T00:00:00,6,Spain,ESP,763,765,https://api.fifa.com/api/v1/picture/flags-sq-4/esp,-2
6,2006-03-15T00:00:00,7,Mexico,MEX,762,765,https://api.fifa.com/api/v1/picture/flags-sq-4/mex,-3
7,2006-03-15T00:00:00,8,France,FRA,760,766,https://api.fifa.com/api/v1/picture/flags-sq-4/fra,-6
8,2006-03-15T00:00:00,9,England,ENG,756,758,https://api.fifa.com/api/v1/picture/flags-sq-4/eng,-2
9,2006-03-15T00:00:00,10,Portugal,POR,755,756,https://api.fifa.com/api/v1/picture/flags-sq-4/por,-1
10,2006-03-15T00:00:00,11,Turkey,TUR,743,746,https://api.fifa.com/api/v1/picture/flags-sq-4/tur,-3
11,2006-03-15T00:00:00,12,Italy,ITA,738,738,https://api.fifa.com/api/v1/picture/flags-sq-4/ita,0
12,2006-03-15T00:00:00,12,Nigeria,NGA,738,738,https://api.fifa.com/api/v1/picture/flags-sq-4/nga,0
13,2006-03-15T00:00:00,14,Denmark,DEN,736,735,https://api.fifa.com/api/v1/picture/flags-sq-4/den,1
14,2006-03-15T00:00:00,15,Cameroon,CMR,726,727,https://api.fifa.com/api/v1/picture/flags-sq-4/cmr,-1
15,2006-03-15T00:00:00,16,Sweden,SWE,725,729,https://api.fifa.com/api/v1/picture/flags-sq-4/swe,-4
16,2006-03-15T00:00:00,17,Egypt,EGY,714,714,https://api.fifa.com/api/v1/picture/flags-sq-4/egy,0
17,2006-03-15T00:00:00,18,Japan,JPN,712,712,https://api.fifa.com/api/v1/picture/flags-sq-4/jpn,0
18,2006-03-15T00:00:00,19,IR Iran,IRN,705,702,https://api.fifa.com/api/v1/picture/flags-sq-4/irn,3
19,2006-03-15T00:00:00,19,Croatia,CRO,705,701,https://api.fifa.com/api/v1/picture/flags-sq-4/cro,4
20,2006-03-15T00:00:00,21,Greece,GRE,704,706,https://api.fifa.com/api/v1/picture/flags-sq-4/gre,-2
21,2006-03-15T00:00:00,22,Germany,GER,700,706,https://api.fifa.com/api/v1/picture/flags-sq-4/ger,-6
22,2006-03-15T00:00:00,23,Uruguay,URU,699,703,https://api.fifa.com/api/v1/picture/flags-sq-4/uru,-4
23,2006-03-15T00:00:00,24,Tunisia,TUN,698,701,https://api.fifa.com/api/v1/picture/flags-sq-4/tun,-3
24,2006-03-15T00:00:00,25,Costa Rica,CRC,694,700,https://api.fifa.com/api/v1/picture/flags-sq-4/crc,-6
25,2006-03-15T00:00:00,26,Poland,POL,691,697,https://api.fifa.com/api/v1/picture/flags-sq-4/pol,-6
26,2006-03-15T00:00:00,26,Romania,ROU,691,685,https://api.fifa.com/api/v1/picture/flags-sq-4/rou,6
27,2006-03-15T00:00:00,28,Senegal,SEN,689,686,https://api.fifa.com/api/v1/picture/flags-sq-4/sen,3
28,2006-03-15T00:00:00,29,Republic of Ireland,IRL,687,689,https://api.fifa.com/api/v1/picture/flags-sq-4/irl,-2
29,2006-03-15T00:00:00,30,Colombia,COL,686,689,https://api.fifa.com/api/v1/picture/flags-sq-4/col,-3
30,2006-03-15T00:00:00,31,Korea Republic,KOR,683,679,https://api.fifa.com/api/v1/picture/flags-sq-4/kor,4
31,2006-03-15T00:00:00,32,CÃ´te d'Ivoire,CIV,671,674,https://api.fifa.com/api/v1/picture/flags-sq-4/civ,-3
32,2006-03-15T00:00:00,33,Paraguay,PAR,666,669,https://api.fifa.com/api/v1/picture/flags-sq-4/par,-3
33,2006-03-15T00:00:00,34,Saudi Arabia,KSA,660,661,https://api.fifa.com/api/v1/picture/flags-sq-4/ksa,-1
34,2006-03-15T00:00:00,35,Russia,RUS,657,664,https://api.fifa.com/api/v1/picture/flags-sq-4/rus,-7
35,2006-03-15T00:00:00,35,Switzerland,SUI,657,653,https://api.fifa.com/api/v1/picture/flags-sq-4/sui,4
36,2006-03-15T00:00:00,37,Morocco,MAR,653,654,https://api.fifa.com/api/v1/picture/flags-sq-4/mar,-1
37,2006-03-15T00:00:00,38,Ecuador,ECU,644,650,https://api.fifa.com/api/v1/picture/flags-sq-4/ecu,-6
38,2006-03-15T00:00:00,39,Bulgaria,BUL,643,638,https://api.fifa.com/api/v1/picture/flags-sq-4/bul,5
39,2006-03-15T00:00:00,39,Norway,NOR,643,647,https://api.fifa.com/api/v1/picture/flags-sq-4/nor,-4
40,2006-03-15T00:00:00,41,Slovakia,SVK,627,620,https://api.fifa.com/api/v1/picture/flags-sq-4/svk,7
41,2006-03-15T00:00:00,42,Ukraine,UKR,624,627,https://api.fifa.com/api/v1/picture/flags-sq-4/ukr,-3
42,2006-03-15T00:00:00,43,Honduras,HON,623,626,https://api.fifa.com/api/v1/picture/flags-sq-4/hon,-3
43,2006-03-15T00:00:00,44,Australia,AUS,621,609,https://api.fifa.com/api/v1/picture/flags-sq-4/aus,12
44,2006-03-15T00:00:00,45,Jamaica,JAM,620,624,https://api.fifa.com/api/v1/picture/flags-sq-4/jam,-4
45,2006-03-15T00:00:00,46,Serbia and Montenegro,SCG,616,611,https://api.fifa.com/api/v1/picture/flags-sq-4/scg,5
46,2006-03-15T00:00:00,47,Israel,ISR,615,622,https://api.fifa.com/api/v1/picture/flags-sq-4/isr,-7
47,2006-03-15T00:00:00,48,Finland,FIN,610,612,https://api.fifa.com/api/v1/picture/flags-sq-4/fin,-2
48,2006-03-15T00:00:00,49,Trinidad and Tobago,TRI,607,607,https://api.fifa.com/api/v1/picture/flags-sq-4/tri,0
49,2006-03-15T00:00:00,50,Ghana,GHA,605,609,https://api.fifa.com/api/v1/picture/flags-sq-4/gha,-4
50,2006-03-15T00:00:00,50,Belgium,BEL,605,599,https://api.fifa.com/api/v1/picture/flags-sq-4/bel,6
51,2006-03-15T00:00:00,52,South Africa,RSA,604,608,https://api.fifa.com/api/v1/picture/flags-sq-4/rsa,-4
52,2006-03-15T00:00:00,53,Zimbabwe,ZIM,602,601,https://api.fifa.com/api/v1/picture/flags-sq-4/zim,1
53,2006-03-15T00:00:00,54,Bahrain,BHR,599,601,https://api.fifa.com/api/v1/picture/flags-sq-4/bhr,-2
54,2006-03-15T00:00:00,55,Iraq,IRQ,596,596,https://api.fifa.com/api/v1/picture/flags-sq-4/irq,0
55,2006-03-15T00:00:00,56,Guinea,GUI,594,594,https://api.fifa.com/api/v1/picture/flags-sq-4/gui,0
56,2006-03-15T00:00:00,57,Zambia,ZAM,591,591,https://api.fifa.com/api/v1/picture/flags-sq-4/zam,0
57,2006-03-15T00:00:00,58,Togo,TOG,580,583,https://api.fifa.com/api/v1/picture/flags-sq-4/tog,-3
58,2006-03-15T00:00:00,58,Guatemala,GUA,580,584,https://api.fifa.com/api/v1/picture/flags-sq-4/gua,-4
59,2006-03-15T00:00:00,60,Angola,ANG,577,582,https://api.fifa.com/api/v1/picture/flags-sq-4/ang,-5
60,2006-03-15T00:00:00,61,Uzbekistan,UZB,573,571,https://api.fifa.com/api/v1/picture/flags-sq-4/uzb,2
61,2006-03-15T00:00:00,62,Scotland,SCO,567,571,https://api.fifa.com/api/v1/picture/flags-sq-4/sco,-4
62,2006-03-15T00:00:00,63,Belarus,BLR,565,568,https://api.fifa.com/api/v1/picture/flags-sq-4/blr,-3
63,2006-03-15T00:00:00,64,Mali,MLI,564,567,https://api.fifa.com/api/v1/picture/flags-sq-4/mli,-3
64,2006-03-15T00:00:00,64,Bosnia and Herzegovina,BIH,564,561,https://api.fifa.com/api/v1/picture/flags-sq-4/bih,3
65,2006-03-15T00:00:00,66,Peru,PER,557,558,https://api.fifa.com/api/v1/picture/flags-sq-4/per,-1
66,2006-03-15T00:00:00,67,Chile,CHI,556,560,https://api.fifa.com/api/v1/picture/flags-sq-4/chi,-4
67,2006-03-15T00:00:00,68,Latvia,LVA,555,558,https://api.fifa.com/api/v1/picture/flags-sq-4/lva,-3
68,2006-03-15T00:00:00,69,Slovenia,SVN,554,551,https://api.fifa.com/api/v1/picture/flags-sq-4/svn,3
69,2006-03-15T00:00:00,70,Venezuela,VEN,551,553,https://api.fifa.com/api/v1/picture/flags-sq-4/ven,-2
70,2006-03-15T00:00:00,71,China PR,CHN,549,546,https://api.fifa.com/api/v1/picture/flags-sq-4/chn,3
71,2006-03-15T00:00:00,72,Kuwait,KUW,548,546,https://api.fifa.com/api/v1/picture/flags-sq-4/kuw,2
72,2006-03-15T00:00:00,72,Hungary,HUN,548,550,https://api.fifa.com/api/v1/picture/flags-sq-4/hun,-2
73,2006-03-15T00:00:00,74,Congo DR,COD,547,548,https://api.fifa.com/api/v1/picture/flags-sq-4/cod,-1
74,2006-03-15T00:00:00,75,Austria,AUT,545,551,https://api.fifa.com/api/v1/picture/flags-sq-4/aut,-6
75,2006-03-15T00:00:00,76,Wales,WAL,544,547,https://api.fifa.com/api/v1/picture/flags-sq-4/wal,-3
76,2006-03-15T00:00:00,77,Qatar,QAT,543,488,https://api.fifa.com/api/v1/picture/flags-sq-4/qat,55
77,2006-03-15T00:00:00,78,Cuba,CUB,541,544,https://api.fifa.com/api/v1/picture/flags-sq-4/cub,-3
78,2006-03-15T00:00:00,79,Estonia,EST,539,544,https://api.fifa.com/api/v1/picture/flags-sq-4/est,-5
79,2006-03-15T00:00:00,80,United Arab Emirates,UAE,537,518,https://api.fifa.com/api/v1/picture/flags-sq-4/uae,19
80,2006-03-15T00:00:00,81,Panama,PAN,532,536,https://api.fifa.com/api/v1/picture/flags-sq-4/pan,-4
81,2006-03-15T00:00:00,81,Oman,OMA,532,491,https://api.fifa.com/api/v1/picture/flags-sq-4/oma,41
82,2006-03-15T00:00:00,83,Jordan,JOR,525,506,https://api.fifa.com/api/v1/picture/flags-sq-4/jor,19
83,2006-03-15T00:00:00,84,Libya,LBY,519,522,https://api.fifa.com/api/v1/picture/flags-sq-4/lby,-3
84,2006-03-15T00:00:00,85,Algeria,ALG,517,520,https://api.fifa.com/api/v1/picture/flags-sq-4/alg,-3
85,2006-03-15T00:00:00,85,Canada,CAN,517,510,https://api.fifa.com/api/v1/picture/flags-sq-4/can,7
86,2006-03-15T00:00:00,87,Korea DPR,PRK,515,519,https://api.fifa.com/api/v1/picture/flags-sq-4/prk,-4
87,2006-03-15T00:00:00,88,Albania,ALB,514,519,https://api.fifa.com/api/v1/picture/flags-sq-4/alb,-5
88,2006-03-15T00:00:00,89,Syria,SYR,506,481,https://api.fifa.com/api/v1/picture/flags-sq-4/syr,25
89,2006-03-15T00:00:00,90,Burkina Faso,BFA,503,504,https://api.fifa.com/api/v1/picture/flags-sq-4/bfa,-1
90,2006-03-15T00:00:00,91,FYR Macedonia,MKD,497,500,https://api.fifa.com/api/v1/picture/flags-sq-4/mkd,-3
91,2006-03-15T00:00:00,92,Rwanda,RWA,484,486,https://api.fifa.com/api/v1/picture/flags-sq-4/rwa,-2
92,2006-03-15T00:00:00,92,Singapore,SIN,484,482,https://api.fifa.com/api/v1/picture/flags-sq-4/sin,2
93,2006-03-15T00:00:00,94,Kenya,KEN,483,486,https://api.fifa.com/api/v1/picture/flags-sq-4/ken,-3
94,2006-03-15T00:00:00,95,Sudan,SDN,480,482,https://api.fifa.com/api/v1/picture/flags-sq-4/sdn,-2
95,2006-03-15T00:00:00,96,Lithuania,LTU,478,465,https://api.fifa.com/api/v1/picture/flags-sq-4/ltu,13
96,2006-03-15T00:00:00,97,Iceland,ISL,477,480,https://api.fifa.com/api/v1/picture/flags-sq-4/isl,-3
97,2006-03-15T00:00:00,98,Uganda,UGA,472,474,https://api.fifa.com/api/v1/picture/flags-sq-4/uga,-2
98,2006-03-15T00:00:00,98,Cyprus,CYP,472,470,https://api.fifa.com/api/v1/picture/flags-sq-4/cyp,2
99,2006-03-15T00:00:00,98,Northern Ireland,NIR,472,463,https://api.fifa.com/api/v1/picture/flags-sq-4/nir,9
100,2006-03-15T00:00:00,101,Bolivia,BOL,469,470,https://api.fifa.com/api/v1/picture/flags-sq-4/bol,-1
101,2006-03-15T00:00:00,102,Botswana,BOT,462,465,https://api.fifa.com/api/v1/picture/flags-sq-4/bot,-3
102,2006-03-15T00:00:00,103,Haiti,HAI,460,463,https://api.fifa.com/api/v1/picture/flags-sq-4/hai,-3
103,2006-03-15T00:00:00,104,Georgia,GEO,459,457,https://api.fifa.com/api/v1/picture/flags-sq-4/geo,2
104,2006-03-15T00:00:00,105,Gabon,GAB,455,458,https://api.fifa.com/api/v1/picture/flags-sq-4/gab,-3
105,2006-03-15T00:00:00,106,Malawi,MWI,446,449,https://api.fifa.com/api/v1/picture/flags-sq-4/mwi,-3
106,2006-03-15T00:00:00,107,Moldova,MDA,437,440,https://api.fifa.com/api/v1/picture/flags-sq-4/mda,-3
107,2006-03-15T00:00:00,108,Thailand,THA,435,422,https://api.fifa.com/api/v1/picture/flags-sq-4/tha,13
108,2006-03-15T00:00:00,109,Armenia,ARM,427,430,https://api.fifa.com/api/v1/picture/flags-sq-4/arm,-3
109,2006-03-15T00:00:00,110,Indonesia,IDN,413,416,https://api.fifa.com/api/v1/picture/flags-sq-4/idn,-3
110,2006-03-15T00:00:00,111,Congo,CGO,407,410,https://api.fifa.com/api/v1/picture/flags-sq-4/cgo,-3
111,2006-03-15T00:00:00,112,Ethiopia,ETH,397,398,https://api.fifa.com/api/v1/picture/flags-sq-4/eth,-1
112,2006-03-15T00:00:00,113,Benin,BEN,394,395,https://api.fifa.com/api/v1/picture/flags-sq-4/ben,-1
113,2006-03-15T00:00:00,114,Azerbaijan,AZE,392,392,https://api.fifa.com/api/v1/picture/flags-sq-4/aze,0
114,2006-03-15T00:00:00,115,Hong Kong,HKG,383,382,https://api.fifa.com/api/v1/picture/flags-sq-4/hkg,1
115,2006-03-15T00:00:00,115,New Zealand,NZL,383,366,https://api.fifa.com/api/v1/picture/flags-sq-4/nzl,17
116,2006-03-15T00:00:00,117,Barbados,BRB,382,385,https://api.fifa.com/api/v1/picture/flags-sq-4/brb,-3
117,2006-03-15T00:00:00,118,Turkmenistan,TKM,381,384,https://api.fifa.com/api/v1/picture/flags-sq-4/tkm,-3
118,2006-03-15T00:00:00,118,India,IND,381,380,https://api.fifa.com/api/v1/picture/flags-sq-4/ind,1
119,2006-03-15T00:00:00,120,Lebanon,LBN,380,369,https://api.fifa.com/api/v1/picture/flags-sq-4/lbn,11
120,2006-03-15T00:00:00,121,Palestine,PLE,377,313,https://api.fifa.com/api/v1/picture/flags-sq-4/ple,64
121,2006-03-15T00:00:00,122,Malta,MLT,368,374,https://api.fifa.com/api/v1/picture/flags-sq-4/mlt,-6
122,2006-03-15T00:00:00,122,Cape Verde Islands,CPV,368,370,https://api.fifa.com/api/v1/picture/flags-sq-4/cpv,-2
123,2006-03-15T00:00:00,124,Liechtenstein,LIE,364,365,https://api.fifa.com/api/v1/picture/flags-sq-4/lie,-1
124,2006-03-15T00:00:00,124,Vietnam,VIE,364,366,https://api.fifa.com/api/v1/picture/flags-sq-4/vie,-2
125,2006-03-15T00:00:00,126,Malaysia,MAS,354,356,https://api.fifa.com/api/v1/picture/flags-sq-4/mas,-2
126,2006-03-15T00:00:00,127,Andorra,AND,353,355,https://api.fifa.com/api/v1/picture/flags-sq-4/and,-2
127,2006-03-15T00:00:00,127,El Salvador,SLV,353,355,https://api.fifa.com/api/v1/picture/flags-sq-4/slv,-2
128,2006-03-15T00:00:00,129,St. Lucia,LCA,340,343,https://api.fifa.com/api/v1/picture/flags-sq-4/lca,-3
129,2006-03-15T00:00:00,130,Yemen,YEM,336,309,https://api.fifa.com/api/v1/picture/flags-sq-4/yem,27
130,2006-03-15T00:00:00,131,St. Kitts and Nevis,SKN,334,336,https://api.fifa.com/api/v1/picture/flags-sq-4/skn,-2
131,2006-03-15T00:00:00,132,Mozambique,MOZ,333,335,https://api.fifa.com/api/v1/picture/flags-sq-4/moz,-2
132,2006-03-15T00:00:00,133,St. Vincent and the Grenadines,VIN,332,334,https://api.fifa.com/api/v1/picture/flags-sq-4/vin,-2
133,2006-03-15T00:00:00,134,Kazakhstan,KAZ,323,314,https://api.fifa.com/api/v1/picture/flags-sq-4/kaz,9
134,2006-03-15T00:00:00,135,Faroe Islands,FRO,321,323,https://api.fifa.com/api/v1/picture/flags-sq-4/fro,-2
135,2006-03-15T00:00:00,136,Maldives,MDV,320,322,https://api.fifa.com/api/v1/picture/flags-sq-4/mdv,-2
136,2006-03-15T00:00:00,137,Eswatini,SWZ,318,321,https://api.fifa.com/api/v1/picture/flags-sq-4/swz,-3
137,2006-03-15T00:00:00,138,Fiji,FIJ,314,316,https://api.fifa.com/api/v1/picture/flags-sq-4/fij,-2
138,2006-03-15T00:00:00,139,Liberia,LBR,313,316,https://api.fifa.com/api/v1/picture/flags-sq-4/lbr,-3
139,2006-03-15T00:00:00,140,Solomon Islands,SOL,300,302,https://api.fifa.com/api/v1/picture/flags-sq-4/sol,-2
140,2006-03-15T00:00:00,141,Tajikistan,TJK,297,298,https://api.fifa.com/api/v1/picture/flags-sq-4/tjk,-1
141,2006-03-15T00:00:00,142,Tahiti,TAH,296,298,https://api.fifa.com/api/v1/picture/flags-sq-4/tah,-2
142,2006-03-15T00:00:00,143,Bangladesh,BAN,294,295,https://api.fifa.com/api/v1/picture/flags-sq-4/ban,-1
143,2006-03-15T00:00:00,144,Mauritius,MRI,280,282,https://api.fifa.com/api/v1/picture/flags-sq-4/mri,-2
144,2006-03-15T00:00:00,145,Sri Lanka,SRI,278,280,https://api.fifa.com/api/v1/picture/flags-sq-4/sri,-2
145,2006-03-15T00:00:00,146,Lesotho,LES,264,266,https://api.fifa.com/api/v1/picture/flags-sq-4/les,-2
146,2006-03-15T00:00:00,146,Vanuatu,VAN,264,265,https://api.fifa.com/api/v1/picture/flags-sq-4/van,-1
147,2006-03-15T00:00:00,148,Burundi,BDI,262,264,https://api.fifa.com/api/v1/picture/flags-sq-4/bdi,-2
148,2006-03-15T00:00:00,148,Myanmar,MYA,262,264,https://api.fifa.com/api/v1/picture/flags-sq-4/mya,-2
149,2006-03-15T00:00:00,150,Madagascar,MAD,261,263,https://api.fifa.com/api/v1/picture/flags-sq-4/mad,-2
150,2006-03-15T00:00:00,151,Luxembourg,LUX,253,255,https://api.fifa.com/api/v1/picture/flags-sq-4/lux,-2
151,2006-03-15T00:00:00,152,Grenada,GRN,247,248,https://api.fifa.com/api/v1/picture/flags-sq-4/grn,-1
152,2006-03-15T00:00:00,153,Suriname,SUR,242,243,https://api.fifa.com/api/v1/picture/flags-sq-4/sur,-1
153,2006-03-15T00:00:00,153,Nicaragua,NCA,242,243,https://api.fifa.com/api/v1/picture/flags-sq-4/nca,-1
154,2006-03-15T00:00:00,155,Pakistan,PAK,239,236,https://api.fifa.com/api/v1/picture/flags-sq-4/pak,3
155,2006-03-15T00:00:00,155,Antigua and Barbuda,ATG,239,241,https://api.fifa.com/api/v1/picture/flags-sq-4/atg,-2
156,2006-03-15T00:00:00,157,Chinese Taipei,TPE,236,236,https://api.fifa.com/api/v1/picture/flags-sq-4/tpe,0
157,2006-03-15T00:00:00,158,San Marino,SMR,235,237,https://api.fifa.com/api/v1/picture/flags-sq-4/smr,-2
158,2006-03-15T00:00:00,159,Kyrgyz Republic,KGZ,233,235,https://api.fifa.com/api/v1/picture/flags-sq-4/kgz,-2
159,2006-03-15T00:00:00,160,Chad,CHA,228,228,https://api.fifa.com/api/v1/picture/flags-sq-4/cha,0
160,2006-03-15T00:00:00,161,Bermuda,BER,216,218,https://api.fifa.com/api/v1/picture/flags-sq-4/ber,-2
161,2006-03-15T00:00:00,161,Namibia,NAM,216,218,https://api.fifa.com/api/v1/picture/flags-sq-4/nam,-2
162,2006-03-15T00:00:00,163,Guyana,GUY,211,184,https://api.fifa.com/api/v1/picture/flags-sq-4/guy,27
163,2006-03-15T00:00:00,163,Sierra Leone,SLE,211,212,https://api.fifa.com/api/v1/picture/flags-sq-4/sle,-1
164,2006-03-15T00:00:00,165,Equatorial Guinea,EQG,207,168,https://api.fifa.com/api/v1/picture/flags-sq-4/eqg,39
165,2006-03-15T00:00:00,166,Gambia,GAM,203,205,https://api.fifa.com/api/v1/picture/flags-sq-4/gam,-2
166,2006-03-15T00:00:00,167,Tanzania,TAN,195,195,https://api.fifa.com/api/v1/picture/flags-sq-4/tan,0
167,2006-03-15T00:00:00,168,Papua New Guinea,PNG,189,190,https://api.fifa.com/api/v1/picture/flags-sq-4/png,-1
168,2006-03-15T00:00:00,170,Eritrea,ERI,180,181,https://api.fifa.com/api/v1/picture/flags-sq-4/eri,-1
169,2006-03-15T00:00:00,171,Laos,LAO,178,180,https://api.fifa.com/api/v1/picture/flags-sq-4/lao,-2
170,2006-03-15T00:00:00,172,British Virgin Islands,VGB,174,175,https://api.fifa.com/api/v1/picture/flags-sq-4/vgb,-1
171,2006-03-15T00:00:00,173,Dominica,DMA,169,170,https://api.fifa.com/api/v1/picture/flags-sq-4/dma,-1
172,2006-03-15T00:00:00,174,Dominican Republic,DOM,155,156,https://api.fifa.com/api/v1/picture/flags-sq-4/dom,-1
173,2006-03-15T00:00:00,175,Nepal,NEP,151,152,https://api.fifa.com/api/v1/picture/flags-sq-4/nep,-1
174,2006-03-15T00:00:00,176,Seychelles,SEY,150,151,https://api.fifa.com/api/v1/picture/flags-sq-4/sey,-1
175,2006-03-15T00:00:00,177,Niger,NIG,142,143,https://api.fifa.com/api/v1/picture/flags-sq-4/nig,-1
176,2006-03-15T00:00:00,178,Mauritania,MTN,137,138,https://api.fifa.com/api/v1/picture/flags-sq-4/mtn,-1
177,2006-03-15T00:00:00,179,Mongolia,MNG,136,136,https://api.fifa.com/api/v1/picture/flags-sq-4/mng,0
178,2006-03-15T00:00:00,180,Belize,BLZ,133,134,https://api.fifa.com/api/v1/picture/flags-sq-4/blz,-1
179,2006-03-15T00:00:00,181,Central African Republic,CTA,132,127,https://api.fifa.com/api/v1/picture/flags-sq-4/cta,5
180,2006-03-15T00:00:00,182,Cayman Islands,CAY,131,132,https://api.fifa.com/api/v1/picture/flags-sq-4/cay,-1
181,2006-03-15T00:00:00,183,Samoa,SAM,130,131,https://api.fifa.com/api/v1/picture/flags-sq-4/sam,-1
182,2006-03-15T00:00:00,184,Somalia,SOM,111,111,https://api.fifa.com/api/v1/picture/flags-sq-4/som,0
183,2006-03-15T00:00:00,185,Tonga,TGA,108,109,https://api.fifa.com/api/v1/picture/flags-sq-4/tga,-1
184,2006-03-15T00:00:00,185,Guinea-Bissau,GNB,108,108,https://api.fifa.com/api/v1/picture/flags-sq-4/gnb,0
185,2006-03-15T00:00:00,187,New Caledonia,NCL,103,104,https://api.fifa.com/api/v1/picture/flags-sq-4/ncl,-1
186,2006-03-15T00:00:00,188,Cambodia,CAM,94,95,https://api.fifa.com/api/v1/picture/flags-sq-4/cam,-1
187,2006-03-15T00:00:00,189,Afghanistan,AFG,84,84,https://api.fifa.com/api/v1/picture/flags-sq-4/afg,0
188,2006-03-15T00:00:00,190,Bhutan,BHU,83,83,https://api.fifa.com/api/v1/picture/flags-sq-4/bhu,0
189,2006-03-15T00:00:00,191,Philippines,PHI,76,77,https://api.fifa.com/api/v1/picture/flags-sq-4/phi,-1
190,2006-03-15T00:00:00,192,Macau,MAC,74,74,https://api.fifa.com/api/v1/picture/flags-sq-4/mac,0
191,2006-03-15T00:00:00,193,Bahamas,BAH,67,67,https://api.fifa.com/api/v1/picture/flags-sq-4/bah,0
192,2006-03-15T00:00:00,194,Cook Islands,COK,64,65,https://api.fifa.com/api/v1/picture/flags-sq-4/cok,-1
193,2006-03-15T00:00:00,195,Puerto Rico,PUR,62,62,https://api.fifa.com/api/v1/picture/flags-sq-4/pur,0
194,2006-03-15T00:00:00,196,US Virgin Islands,VIR,57,57,https://api.fifa.com/api/v1/picture/flags-sq-4/vir,0
195,2006-03-15T00:00:00,197,Sao Tome e Principe,STP,55,55,https://api.fifa.com/api/v1/picture/flags-sq-4/stp,0
196,2006-03-15T00:00:00,198,Anguilla,AIA,52,52,https://api.fifa.com/api/v1/picture/flags-sq-4/aia,0
197,2006-03-15T00:00:00,199,Brunei Darussalam,BRU,48,48,https://api.fifa.com/api/v1/picture/flags-sq-4/bru,0
198,2006-03-15T00:00:00,200,Djibouti,DJI,46,46,https://api.fifa.com/api/v1/picture/flags-sq-4/dji,0
199,2006-03-15T00:00:00,200,Aruba,ARU,46,46,https://api.fifa.com/api/v1/picture/flags-sq-4/aru,0
200,2006-03-15T00:00:00,202,Montserrat,MSR,30,30,https://api.fifa.com/api/v1/picture/flags-sq-4/msr,0
201,2006-03-15T00:00:00,203,Turks and Caicos Islands,TCA,22,22,https://api.fifa.com/api/v1/picture/flags-sq-4/tca,0
202,2006-03-15T00:00:00,204,Guam,GUM,19,19,https://api.fifa.com/api/v1/picture/flags-sq-4/gum,0
203,2006-03-15T00:00:00,205,American Samoa,ASA,15,15,https://api.fifa.com/api/v1/picture/flags-sq-4/asa,0
